6 6 6 6 6 6 6 6 6 6 6 6 6 6 6 6 6 6 6 6
6 0 0 0 0 0 4 3 3 3 3 3 3 4 0 0 0 0 0 6
6 0 0 0 0 0 0 3 3 3 3 3 3 0 0 0 0 0 0 6
6 0 0 0 0 4 0 0 0 6 6 0 0 0 4 0 0 0 0 6
6 0 0 0 4 4 4 0 0 6 6 0 0 4 4 4 0 0 0 6
6 0 0 0 0 4 0 0 0 6 6 0 0 0 4 0 0 0 0 6
6 0 0 0 0 0 0 0 0 6 6 0 0 0 0 0 0 0 0 6
6 0 0 0 0 0 0 0 0 6 6 0 0 0 0 0 0 0 0 6
6 0 0 0 0 0 0 0 0 6 6 0 0 0 0 0 0 0 0 6
6 0 0 0 0 0 0 0 0 6 6 0 0 0 0 0 0 0 0 6
6 0 0 0 0 0 0 0 0 6 6 0 0 0 0 0 0 0 0 6
6 0 0 0 0 0 0 0 0 6 6 0 0 0 0 0 0 0 0 6
6 0 0 0 0 0 0 0 0 6 6 0 0 0 0 0 0 0 0 6
6 0 0 0 0 0 0 0 0 6 6 0 0 0 0 0 0 0 0 6
6 0 0 0 0 0 0 0 0 6 6 0 0 0 0 0 0 0 0 6
6 0 0 0 0 0 0 0 0 6 6 0 0 0 0 0 0 0 0 6
6 0 0 0 0 0 0 0 0 6 6 0 0 0 0 0 0 0 0 6
6 0 0 0 0 0 0 0 0 6 6 0 0 0 0 0 0 0 0 6
6 1 0 0 0 0 0 0 0 6 6 0 0 0 0 0 0 0 2 6
6 6 6 6 6 6 6 6 6 6 6 6 6 6 6 6 6 6 6 6
