6 6 6 6 6 6 6 6 6 6 6 6 6 6 6 6 6 6 6 6
6 6 3 3 3 3 3 3 6 6 6 0 0 0 0 0 0 0 0 6
6 6 6 6 3 3 6 6 6 6 6 4 6 6 6 6 6 6 0 6
6 6 3 3 3 3 3 3 6 6 6 0 0 0 0 0 0 0 0 6
6 6 6 6 0 0 6 6 6 6 6 4 6 6 6 6 6 6 0 6
6 0 0 4 0 0 6 6 6 6 6 0 0 0 0 0 0 0 0 6
6 0 6 4 0 0 6 6 6 6 6 4 6 6 6 6 6 6 0 6
6 0 0 4 0 6 6 6 6 6 6 0 0 0 0 0 0 0 0 6
6 0 6 4 0 6 6 6 6 6 6 4 6 6 6 6 6 6 0 6
6 0 0 4 0 6 6 6 6 6 6 0 0 0 0 0 0 0 0 6
6 0 6 4 0 6 6 6 6 6 6 4 6 6 6 6 6 6 0 6
6 0 0 0 0 6 6 6 6 6 6 0 0 0 0 0 0 0 0 6
6 6 6 6 0 6 6 6 6 6 6 4 6 6 6 6 6 6 0 6
6 6 6 6 0 6 6 6 6 6 6 0 0 0 0 0 0 0 0 6
6 6 6 6 0 6 6 6 6 6 6 4 6 6 6 6 6 6 0 6
6 6 6 6 0 6 6 6 6 6 6 0 0 0 0 0 0 0 0 6
6 6 6 6 0 6 6 6 6 6 6 4 6 6 6 6 6 6 0 6
6 6 6 6 0 0 0 0 0 1 2 0 0 6 6 6 6 6 0 6
6 6 6 6 0 6 6 6 6 6 6 6 0 0 0 0 0 0 0 6
6 6 6 6 6 6 6 6 6 6 6 6 6 6 6 6 6 6 6 6
