6 6 6 6 6 6 6 6 6 6 6 6 6 6 6 6 6 6 6 6
6 6 6 6 6 6 3 3 3 6 6 6 6 6 6 6 6 6 6 6
6 6 6 6 6 6 3 3 3 6 6 6 6 6 6 6 6 6 6 6
6 6 6 6 6 0 3 3 3 6 6 6 6 6 6 6 6 6 6 6
6 6 6 6 6 0 3 3 3 6 6 6 6 6 0 0 0 0 0 6
6 6 6 6 6 6 0 6 6 6 6 6 6 6 0 4 0 4 0 6
6 6 6 6 6 6 0 0 0 6 6 0 0 0 0 4 0 4 0 6
6 0 0 0 0 0 0 0 0 6 6 0 0 0 0 4 0 4 0 6
6 6 4 6 6 6 0 0 1 6 6 2 0 0 0 4 0 4 0 6
6 0 0 0 0 0 0 0 0 6 6 6 6 6 0 6 6 6 6 6
6 6 4 6 6 6 0 6 6 6 6 6 6 6 0 6 6 6 6 6
6 0 0 0 0 0 0 6 6 6 6 6 6 6 0 6 6 6 6 6
6 6 4 6 6 6 0 6 6 6 6 6 6 6 0 6 6 6 6 6
6 0 0 0 0 0 0 6 6 6 6 6 6 6 0 6 6 6 6 6
6 6 4 6 6 6 0 6 6 6 6 6 6 6 0 6 6 6 6 6
6 0 0 0 0 0 0 6 6 6 6 6 6 6 0 6 6 6 6 6
6 6 6 6 6 6 0 6 6 6 6 6 6 6 0 0 6 6 6 6
6 6 6 6 6 6 0 0 0 0 0 0 0 0 0 0 6 6 6 6
6 6 6 6 6 6 0 6 6 6 6 6 6 6 6 6 6 6 6 6
6 6 6 6 6 6 6 6 6 6 6 6 6 6 6 6 6 6 6 6
