6 6 6 6 6 6 6 6 6 6 6 6 6 6 6 6 6 6 6 6
6 3 3 3 3 3 3 3 3 6 0 0 0 6 0 0 0 0 0 6
6 3 3 3 3 3 3 3 3 6 0 6 0 6 0 6 6 6 0 6
6 3 3 3 3 3 3 3 3 6 0 6 0 6 0 6 0 0 0 6
6 3 3 3 3 3 3 3 3 0 0 6 0 0 0 6 0 6 6 6
6 0 0 6 6 6 6 6 4 6 6 6 6 6 6 6 0 0 0 6
6 4 6 0 0 0 0 1 0 6 6 0 6 6 0 0 6 6 2 6
6 0 6 0 6 0 4 4 0 6 6 0 0 0 0 0 4 0 0 6
6 0 6 0 6 0 4 0 4 6 6 0 6 6 4 4 0 4 0 6
6 0 6 0 6 0 4 0 0 6 6 0 0 6 0 6 6 4 0 6
6 0 6 0 6 0 4 0 4 6 6 0 4 6 0 4 0 4 0 6
6 0 0 0 6 0 4 0 0 6 6 0 0 6 0 0 0 0 0 6
6 6 6 6 6 0 0 4 4 6 6 0 4 6 0 6 6 6 0 6
6 0 0 0 0 0 0 0 0 6 6 0 0 6 0 0 0 6 0 6
6 0 4 0 6 0 6 6 6 6 6 0 4 6 6 4 0 6 0 6
6 0 4 0 6 0 4 0 0 6 6 0 4 0 0 0 0 6 0 6
6 0 6 4 6 4 6 4 0 6 6 0 6 6 4 6 6 6 0 6
6 0 6 0 4 0 0 0 0 0 0 0 0 6 0 0 0 0 0 6
6 0 0 0 0 0 6 6 6 6 6 6 6 6 6 6 6 6 6 6
6 6 6 6 6 6 6 6 6 6 6 6 6 6 6 6 6 6 6 6
